CCCCCCDDDDDD
CCCCCCDDDDDD
CCCCCCDDDDDD
CCCCCCDDDDDD
CCCCCCDDDDDD
CCCCCCDDDDDD
DDDDDDEEEEEE
DDDDDDEEEEEE
DDDDDDEEEEEE
DDDDDDEEEEEE
DDDDDDEEEEEE
DDDDDDEEEEEE
EEEEEEFFFFFF
EEEEEEFFFFFF
EEEEEEFFFFFF
EEEEEEFFFFFF
EEEEEEFFFFFF
EEEEEEFFFFFF
FFFFFFCCCCCC
FFFFFFCCCCCC
FFFFFFCCCCCC
FFFFFFCCCCCC
FFFFFFCCCCCC
FFFFFFCCCCCC
