--..//--..//--..//--..//--
--..//--..//--..//--..//--
..//--..//--..//--..//--..
..//--..//--..//--..//--..
//--..//--..//--..//--..//
//--..//--..//--..//--..//
